Serenity	Pensiveness
Acceptance	Boredom
Apprehension	Annoyance
Distraction	Interest
Joy	Sadness
Trust	Disgust
Fear	Anger
Surprise	Anticipation
Ecstasy	Grief
Admiration	Loathing
Terror	Rage
Amazement	Vigilance
Optimism	Disapproval
Hope	Unbelief
Anxiety	Outrage
Love	Remorse
Guilt	Envy
Delight	Pessimism
Submission	Contempt
Curiosity	Cynicism
Sentimentality	Morbidness
Awe	Aggressiveness
Despair	Pride
Shame	Dominance